%%%%%%%
%..%..%
%..%..%
%. P .%
%. % .%
%.....%
%%%%%%%
